...######################
..1#....2...#.....#.....#
#..#1.#..#4.#..####..####
#.....#..#...T.#.....#..#
#2.#######..#..#..#..#..#
#.....#..#..#5.#..#.....#
#..#Т.#..####..#..####..#
#..#.....#...3.....#..#
#..#..####..#######..####
#3.#........#..#...6.#..#
#..#..#..#.4#..#..#..#..#
#..#..#..#.....#..#.....#
#..##########..#..#..####
#.....#.......Т...#4....#
#..##########..#######..#
#.....................6..
######################...
